000000000000
0          0
0    3     0
0          0
0          0
0    0     0
0          0
0    0     0
0    000   0
0          0
0          0
000000000000
